1111111111111111111
1000000000000000001
1000000000000000001
1001111000001111001
1001000000000001001
1001000000000001001
1001001110111001001
1001001000001001001
1001001000001001001
1001001000001001001
1001001000001001001
1001001000001001001
1001001000001001001
1001001000001001001
1001001000001001001
1001001000001001001
1001001000001001001
1001001000001001001
1001001110111001001
1001000000000001001
1001000000000001001
1001111000001111001
1000000000000000001
1000000000000000001
1111111111111111111